0,2,1,1,0,0,0,0,0,0,0,0,0,0,0,0,0,0,0,0,0
0,1,2,2,0,0,0,0,0,0,0,0,0,0,0,0,0,0,0,0,0
0,2,2,2,0,0,0,0,0,0,0,0,0,0,0,0,0,0,0,0,0
0,2,2,2,0,0,0,0,0,0,0,0,0,0,0,0,0,0,0,0,0
0,2,1,1,1,0,0,0,0,0,0,0,0,0,0,0,0,0,0,0,0
0,0,0,0,1,1,1,0,0,0,0,1,2,1,2,3,2,1,0,0,0
0,0,0,0,1,2,1,0,0,0,0,0,0,0,0,0,0,0,0,0,0
0,0,0,0,1,1,1,0,0,0,0,0,0,0,0,2,3,5,3,0,0
0,0,0,0,0,0,0,0,0,0,0,0,0,0,0,1,5,7,5,0,0
0,0,0,0,0,0,0,0,0,0,1,0,0,0,0,1,3,5,3,0,0
0,0,0,0,4,0,0,0,0,0,0,0,0,0,0,0,0,0,0,0,0
0,0,0,0,3,5,4,0,0,0,1,0,0,0,0,0,0,0,0,0,0
0,0,0,0,0,0,0,0,0,0,0,0,0,0,0,0,0,0,0,0,0
0,0,0,0,0,0,0,0,0,0,0,0,0,0,1,1,1,1,1,1,1
0,0,0,0,0,0,0,0,0,0,0,0,0,0,1,2,2,2,2,2,1
0,0,0,1,0,0,0,0,3,2,3,1,0,0,1,2,3,3,3,2,1
0,0,1,2,1,0,0,0,0,0,0,0,0,0,1,2,3,4,3,2,1
0,0,1,1,0,0,0,0,0,0,0,0,0,0,1,2,3,3,3,2,1
0,1,2,1,0,0,0,0,0,0,0,0,0,0,1,2,2,2,2,2,1
0,0,1,0,0,0,0,0,0,0,0,0,0,0,1,1,1,1,1,1,1
0,0,0,0,0,0,0,0,0,0,0,0,0,0,0,0,0,0,0,0,0

